Columns: 20
Rows: 20
00000000000000000000
00000000000000000000
00000000000000000000
00000000000000000000
00000000000000000000
00000000000000000000
00000000000000000000
00000000000000000000
00077777777777777000
00077777777777777000
00077777777777777000
00000000000000000000
00000000000000000000
00000000000000000000
00000000000340000000
00000000000560000000
00000000000000000000
00000000000000000000
00000000000000000000
00000000000000000000