Columns: 20
Rows: 20
00000000000000000000
00000000000000000000
00000000022222000000
00000000020002000000
00000000022222000000
00000000000000000000
00000000000000000000
00000000000000000000
00077777777777777000
00077777777777777000
00077777777777777000
00000000000000000000
00000000000000000000
00000000000000000000
00000034343400000000
00000056565600000000
99992222222999999999
99992999992999999999
99992999992999999999
99992222222999999999